NO textures/water.xpm
SO textures/water.xpm
WE textures/water.xpm
F 20,0,255
EA textures/water.xpm
C 225,30,0

111111
1000S1
100001
111011
111111
