NO textures/water.xpm
SO textures/water.xpm
WE textures/water.xpm
EA textures/water.xpm

F 192,192,192
C 135,206,250

        111111111111111111111111
        1000000000110000000000001
        1011000001110000000010001
        100100000000000001000001
11111111101100000111000000E000001
100000000011000001110111112111111
111101111111110111000001011011
11110111111111011101010010101
11000000110101011100000010001
10000000000000001100000010001
10000000000000001101010010001
1100000111010101111101111010111
11110111 1110101 111111010001
11111111 1111111 111111111111
