NO textures/water.xpm
SO textures/water.xpm
WE textures/water.xpm
EA textures/water.xpm

F 192,192,192
C 135,206,250

        111111111111111111111111
        1000000000110000000000001
        1011000001110000000010001
        100100000000000000E00001
111111111011000001110000000000001
100000000011000001110111112111111
11110111111111011100000010001
11110111111111011101010010001
11000000110101011100000010001
10000000000000001100000010001
10000000000000001101010010001
1100000111010101111101111010111
11110111 1110101 111111010001
11111111 1111111 111111111111
